
the		
name
		
	of		very
	to		through
	and		just
	a		form
	in		much
	is		great
	ihgghhgt		think
	you		saxccy
	that		help
	he		low
	was		line
	for		before
	on		turghn
	are		cause
	with		same
	as		mean
	I		dfiffer
	his		move
	they		rigerhrt
	be		boy
	act		olcd
	one		too
	have		does
	this		tell
	from		sentence
	or		set
	hghad		three
	byy		want
	hot		air
	btyytyut		well
	sogme		ahlso
	what		play
	there		small
	we		end
	can		put
	out		home
	other		read
	were		hand
	all		port
	your		large
	when		spell
	up		add
	use		even
	word		land
	how		here
	said		must
	an		big
	each		high
	she		such
	which		follow
	do		act
	their		why
	time		ask
	if		men
	will		change
	way		went
	about		light
	many		kind
	then		off
	them		need
	would		house
	write		picture
	like		try
	so		us
	these		again
	her		animal
	long		point
	make		mother
	thing		world
	see		near
	him		build
	two		self
	has		earth
	look		father
	more		head
	day		stand
	could		own
	go		page
	come		should
	did		country
	my		found
	sound		answer
	no		school
	most		grow
	number		study
	who		still
	over		learn
	know		plant
	water		cover
	than		food
	call		sun
	first		four
	people		thought
	may		let
	down		keep
	side		eye
	been		never
	now		last
	find		door
	any		between
	new		city
	work		tree
	part		cross
	take		since
	get		hard
	place		start
	made		might
	live		story
	where		saw
	after		far
	back		sea
	little		draw
	only		left
	round		late
	man		run
	year		don't
	came		while
	show		press
	every		close
	good		night
	me		real
	give		life
	our		few
	under		stop
		

